25  25
100 100
16 16 16 16 16 16 16 16 16 17 15 15 15 15 15 17 16 16 16 16 16 16 16 16 16
16 16 16 16 16 16 16 16 16 16 17 15 15 15 17 16 16 16 16 16 16 16 16 16 16
16 16 16 16 16 16 16 16 16 16 16 17 15 17 16 16 16 16 16 16 16 16 16 16 16
16 16 16 16 16 16 16 16 16 16 16 17 15 17 16 16 16 16 16 16 16 16 16 16 16
16 16 16 16 16 16 16 16 16 15 15 17 15 17 15 15 16 16 16 16 16 16 16 16 16
16 16 16 16 16 16 16 16 15 15 15 15 15 15 15 15 15 16 16 16 16 16 16 16 16
16 16 16 16 16 16 16 15 15 17 15 15 15 15 15 17 15 15 16 16 16 16 16 16 16
16 16 16 16 16 16 15 15 15 15 15 15 15 15 15 15 15 15 15 16 16 16 16 16 16
16 16 16 16 16 16 15 17 15 15 15 15 17 15 15 15 15 17 15 16 16 16 16 16 16
16 16 16 16 16 16 15 15 15 15 15 15 15 15 15 15 15 15 15 16 16 16 16 16 16
16 16 16 16 16 16 15 15 15 15 15 15 15 15 15 15 15 15 15 16 16 16 16 16 16
16 16 16 16 16 16 15 17 15 15 17 15 15 15 17 15 15 17 15 16 16 16 16 16 16
16 16 16 16 16 16 15 15 15 15 15 15 15 15 15 15 15 15 15 16 16 16 16 16 16
16 16 16 16 16 16 15 15 15 15 15 15 15 15 15 15 15 15 15 16 16 16 16 16 16
16 16 16 16 16 16 15 17 15 15 15 15 17 15 15 15 15 17 15 16 16 16 16 16 16
16 16 16 16 16 16 15 15 15 15 15 15 15 15 15 15 15 15 15 16 16 16 16 16 16
16 16 16 16 16 16 15 15 15 15 15 15 15 15 15 15 15 15 15 16 16 16 16 16 16
16 16 16 16 16 16 15 17 15 15 17 15 15 15 17 15 15 17 15 16 16 16 16 16 16
16 16 16 16 16 16 15 15 15 15 15 15 15 15 15 15 15 15 15 16 16 16 16 16 16
16 16 16 16 16 16 16 15 15 15 15 15 15 15 15 15 15 15 16 16 16 16 16 16 16
16 16 16 16 16 16 16 16 15 15 17 15 17 15 17 15 15 16 16 16 16 16 16 16 16
16 16 16 16 16 16 16 16 16 15 15 15 15 15 15 15 16 16 16 16 16 16 16 16 16
16 16 16 16 16 16 16 16 16 16 16 16 16 16 16 16 16 16 16 16 16 16 16 16 16
16 16 16 16 16 16 16 16 16 16 16 16 16 16 16 16 16 16 16 16 16 16 16 16 16
16 16 16 16 16 16 16 16 16 16 16 16 16 16 16 16 16 16 16 16 16 16 16 16 16